111111111111111111111111111111111111111111111111111
100000001001C01000000C000110110000000C00001110101P1
1000C10001010000C000000C00010001100001000C000010001
1000110101C0010000001000C01000011000100001000011011
1000010000001000000C0C00110000000001000001000000001
10000100000000000C000C00010010100010100010000000001
100000000100100000000101010000010000010001000000001
10000100000010000C000C00010000010001010001000000001
1011110010101101000000011100101000001C0001000110011
1000000100001C01000000C00111E111000001C011111010001
1000000C0000110C00100000C0000C000100110000001111111
100000000001000001111100000010001110010000100000001
111111111111111111111111111111111111111111111111111