111111111111111111111111111111111111111111111111111
100000000000000000000000000000000000000000000000001
100000000000000000000000000000000000000000000000001
100000000000000000000000000000000000000000000000001
100000000000000000000000000000000000000000000000001
110000000000000000000000000000000000000000000000001
110000000000000000000000000000000000000000000000001
11000000000000000000000000000C000000000000000000001
110000000000000000000000000000000000000000000000001
110000000000000000000000000000000000000000000000001
110000000000000000000000000000000000000000000000001
110000000000000000000000000000000000000000000000001
110000000000000000000000000000000000000000000000001
110000000000000000000000000000000000000000000000001
1100000000000000000000000E0000000000000000000000001
110000000000000000000000000000000000000000000000001
110000000000000000000000000000000000000000000000001
110000000000000000000000000000000000000000000000001
110000000000000000000000000000000000000000000000001
110000000000000000000000000000000000000000000000001
110000000000000000000000000000000000000000000000001
110000000000000000000000000000000000000000000000001
110000000000000000000000000000000000000000000000001
110000000000000000000000000000000000000000000000001
110000000000000000000000000000000000000000000000011
1100000000000000000000000000000000000000000000000P1
110000000000000000000000000000000000000000000000001
111111111111111111111111111111111111111111111111111